11111111111111111111
10000001000111111111
1000100000011100E111
10000000000110001111
10000000000111001111
1100100P000000011111
10000000100000001111
1000000010001C000011
1CC00000000000001C11
11111111111111111111